# 关卡文件，地图元素对应的字符：
# 空地(0/空格) 墙壁(#) 目标位置(.) 箱子($) 玩家(@) 玩家在目标位置上(+) 箱子在目标位置上(*)

[level]
0000000000000000
0000000000000000
0000000000000000
0000000000000000
000000###0000000
000000#.#0000000
000000# ####0000
0000###$ $.#0000
0000#. $@###0000
0000####$#000000
0000000#.#000000
0000000###000000
0000000000000000
0000000000000000
0000000000000000
0000000000000000

[level]
0000000000000000
0000000000000000
0000000000000000
000#####00000000
000#   #00000000
000# $$#0###0000
000#@$ #0#.#0000
000### ###.#0000
0000##    .#0000
0000#   #  #0000
0000#   ####0000
0000#####0000000
0000000000000000
0000000000000000
0000000000000000
0000000000000000

[level]
0000000000000000
0000000000000000
0000000000000000
0000000000000000
0000000####00000
00000### @#00000
00000#  $ #00000
0000## # ###0000
0000#  # #.#0000
0000# #  $.#0000
0000# $   .#0000
0000########0000
0000000000000000
0000000000000000
0000000000000000
0000000000000000

[level]
0000000000000000
0000000000000000
0000000000000000
0000000000000000
0000###0###00000
0000#.###.#00000
0000# #  .#00000
0000# $$ @#00000
0000#  $  #00000
0000#  #  #00000
0000#  ####00000
0000####00000000
0000000000000000
0000000000000000
0000000000000000
0000000000000000

[level]
0000000000000000
0000000000000000
0000000000000000
0000000000000000
0000#######00000
0000#     ###000
000##$###   #000
000#   $  $ #000
000#@..# $ ##000
000##..#   #0000
0000########0000
0000000000000000
0000000000000000
0000000000000000
0000000000000000
0000000000000000

[level]
0000000000000000
0000000000000000
0000000000000000
0000000000000000
0000000####00000
0000#### @#00000
0000#  *$ #00000
0000#     #00000
0000## .###00000
00000#$ #0000000
00000# .#0000000
00000####0000000
0000000000000000
0000000000000000
0000000000000000
0000000000000000

[level]
0000000000000000
0000000000000000
0000000000000000
0000000000000000
0000#######00000
0000# @...#00000
0000#   ####0000
000###$    #0000
000#   #$# #0000
000# $ #   #0000
000#   #####0000
000#####00000000
0000000000000000
0000000000000000
0000000000000000
0000000000000000

[level]
0000000000000000
0000000000000000
0000000000000000
0000000000000000
0000######000000
0000#@   ##00000
000## ##$.###000
000#   $ $..#000
000## $ $ ..#000
0000#  ######000
0000####00000000
0000000000000000
0000000000000000
0000000000000000
0000000000000000
0000000000000000

[level]
0000000000000000
0000000000000000
0000000000000000
0000000000000000
000#######000000
000# @#  ##00000
000#  #   #00000
000# $ $ $#00000
000#  ##$ #00000
000## # $ ###000
0000#  .....#000
0000#########000
0000000000000000
0000000000000000
0000000000000000
0000000000000000

[level]
0000000000000000
0000000000000000
0000000000000000
0000000000000000
0000######000000
0000#    #000000
0000# $$$###0000
0000# ..$@ #0000
0000##...$ #0000
00000#  ####0000
00000####0000000
0000000000000000
0000000000000000
0000000000000000
0000000000000000
0000000000000000

[level]
0000000000000000
0000000000000000
0000000000000000
0000000000000000
0000000000000000
000#########0000
000#       ##000
000# $#$#   #000
000#.$.  $$ #000
000#...###@ #000
000#####0####000
0000000000000000
0000000000000000
0000000000000000
0000000000000000
0000000000000000

[level]
0000000000000000
0000000000000000
0000000000000000
0000000000000000
000000####000000
000000#..#000000
00000##. ##00000
00000#.$  #00000
0000##  $ ##0000
0000# $$#@ #0000
0000#      #0000
0000########0000
0000000000000000
0000000000000000
0000000000000000
0000000000000000

[level]
0000000000000000
0000000000000000
0000000000000000
00000####0000000
00000#  #0000000
00000#  #0000000
000### .####0000
000#  .$   #0000
000#@$.. $ #0000
000### $####0000
00000#  #0000000
00000####0000000
0000000000000000
0000000000000000
0000000000000000
0000000000000000

[level]
0000000000000000
0000000000000000
0000000000000000
0000000000000000
0000#####0000000
000##  .####0000
000#  .$.$ #0000
000# $# #$@#0000
000#  . .$ #0000
000# $#$####0000
000#  . .#000000
000#######000000
0000000000000000
0000000000000000
0000000000000000
0000000000000000

[level]
0000000000000000
0000000000000000
0000000000000000
0000000000000000
000######0000000
000#@  .####0000
000#  $$$  #0000
000#.##.##.#0000
000#   $   #0000
000## #.$  #0000
0000#   ####0000
0000#####0000000
0000000000000000
0000000000000000
0000000000000000
0000000000000000

[level]
0000000000000000
0000000000000000
0000000000000000
0000000000000000
00000######00000
00000#.. .#00000
00000#.$ .#00000
0000##$  ###0000
0000# $  $ #0000
0000# ##$# #0000
0000#  @   #0000
0000########0000
0000000000000000
0000000000000000
0000000000000000
0000000000000000

[level]
0000000000000000
0000000000000000
0000000000000000
0000000000000000
0000#######00000
0000#..$..#00000
0000#..#..#00000
0000# $$$ #00000
0000#  $  #00000
0000# $$$ #00000
0000#  #@ #00000
0000#######00000
0000000000000000
0000000000000000
0000000000000000
0000000000000000

[level]
0000000000000000
0000000000000000
0000000000000000
0000000000000000
000#######000000
000#  .$ ###0000
000# .$.$@ #0000
000#*$.$.  #0000
000# .$.$ ##0000
000#  .$  #00000
000########00000
0000000000000000
0000000000000000
0000000000000000
0000000000000000
0000000000000000












